11111111111111111111
10000000000000000001
10000000000000000001
10000121212121200001
10000000000000000001
10000000000000000001
10000000000000000001
10000000000000000001
10000000000000000001
10000000000000000001
10000000000000000001
10000212121212100001
10000000000000000001
10000000000000000001
11111111111111111111