11111111111111111111
10000000000000000001
10000000000000000001
10012100000000000001
10000001000000000001
10000000000000000001
10000000010000000001
10000000000000000001
10000000001000000001
10000000000000000001
10000000000100000001
10000000000000121001
10000000000000000001
10000000000000000001
11111111111111111111