11111111111111111111
10000020000020000001
10000020000000000001
10000020000000000001
12220020022222222221
10000020000000000001
10000020000000000001
10000000000020000001
10000000000020000001
12222222220020022221
10000000000020000001
10000000000020000001
10000020000020000001
10000020000020000001
11111111111111111111