11111111111111111111
10000000000000000001
10000000000000000001
10000000000000020001
10000000000000012001
10000000000000000001
10000000000000000001
10000000001000000001
10000000000000000001
10000000000000000001
10021000000000000001
10002000000000000001
10000000000000000001
10000000000000000001
11111111111111111111