11111111111111111111
10000000000000000001
10000000000000000001
10001212121212120001
10000000200000000001
10000000200000000001
10000000200000000001
10000000222000000001
10000000002000000001
10000000002000000001
10000000002000000001
10001212121212120001
10000000000000000001
10000000000000000001
11111111111111111111