11111111111111111111
10000000000000000001
10000000000000000001
10000000000121212121
12121210000000000001
10000000000000000001
10000000000000000001
10000000000000000001
10000000000121212121
10000000000000000001
11212121000000000001
10000000000000000001
10000000000000000001
10000000000000000001
11111111111111111111