11111111111111111111
10000000020000000001
10000000020000000001
10000000020000000001
10000000020000000001
10000000020000000001
10000000020000000001
12222222222222222221
10000000020000000001
10000000020000000001
10000000020000000001
10000000020000000001
10000000020000000001
10000000020000000001
11111111111111111111